| | | | | | |
| | | * | * |
| | | 6 | 3 |
| s 0 0 0 0 |
| | | 1 | 7 |
| | | * | * |
| | | | | | |