| | | | | | |
| * | * | | |
| 3 | 3 | | |
| s 2 1 4 * |
| | 3 | | | |
| | * | | | |
| | | | | | |
