| | | | | | |
| * | * | | |
| 3 | 2 | | |
| s 2 1 4 * |
| | 4 | | | |
| | * | | | |
| | | | | | |
