| | | | | | | | |
s 0 0 0 5 9 9 * |
| | | | 9 | | | |
| | | | 9 9 9 * |
| | | | | | | | |